ABBEY WOOD	ABW
ABER	ABE
ABERCYNON	ACY
ABERDARE	ABA
ABERDEEN	ABD
ABERDOUR	AUR
ABERDOVEY	AVY
ABERERCH	ABH
ABERGAVENNY	AGV
ABERGELE & PENSARN	AGL
ABERYSTWYTH	AYW
ACCRINGTON	ACR
ACHANALT	AAT
ACHNASHEEN	ACN
ACHNASHELLACH	ACH
ACKLINGTON	ACK
ACLE	ACL
ACOCKS GREEN	ACG
ACTON BRIDGE	ACB
ACTON CENTRAL	ACC
ACTON MAIN LINE	AML
ADDERLEY PARK	ADD
ADDIEWELL	ADW
ADDLESTONE	ASN
ADISHAM	ADM
ADLINGTON (CHESHIRE)	ADC
ADLINGTON (LANCASHIRE)	ADL
ADWICK	AWK
AIGBURTH	AIG
AINSDALE	ANS
AINTREE	AIN
AIRBLES	AIR
AIRDRIE	ADR
ALBANY PARK	AYP
ALBRIGHTON	ALB
ALDERLEY EDGE	ALD
ALDERMASTON	AMT
ALDERSHOT	AHT
ALDRINGTON	AGT
ALEXANDRA PALACE	AAP
ALEXANDRA PARADE	AXP
ALEXANDRIA	ALX
ALFRETON	ALF
ALLOA	ALO
ALLENS WEST	ALW
ALNESS	ASS
ALNMOUTH	ALM
ALRESFORD	ALR
ALSAGER	ASG
ALTHORNE	ALN
ALTHORPE	ALP
ALTNABREAC	ABC
ALTON	AON
ALTRINCHAM	ALT
ALVECHURCH	ALV
AMBERGATE	AMB
AMBERLEY	AMY
AMERSHAM	AMR
AMMANFORD	AMF
ANCASTER	ANC
ANDERSTON	AND
ANDOVER	ADV
ANERLEY	ANZ
ANGMERING	ANG
ANNAN	ANN
ANNIESLAND	ANL
ANSDELL & FAIRHAVEN	AFV
APPERLEY BRIDGE	APY
APPLEBY	APP
APPLEDORE	APD
APPLEFORD	APF
APPLEY BRIDGE	APB
APSLEY	APS
ARBROATH	ARB
ARDGAY	ARD
ARDLUI	AUI
ARDROSSAN HARBOUR	ADS
ARDROSSAN SOUTH BEACH	ASB
ARDROSSAN TOWN	ADN
ARDWICK	ADK
ARGYLE STREET	AGS
ARISAIG	ARG
ARLESEY	ARL
ARMADALE	ARM
ARMATHWAITE	AWT
ARNSIDE	ARN
ARRAM	ARR
ARROCHAR & TARBET	ART
ARUNDEL	ARU
ASCOT	ACT
ASCOTT-UNDER-WYCHWOOD	AUW
ASH	ASH
ASH VALE	AHV
ASHBURYS	ABY
ASHCHURCH FOR TEWKESBURY	ASC
ASHFIELD	ASF
ASHFORD	AFS
ASHFORD INTERNATIONAL	AFK
ASHLEY	ASY
ASHTEAD	AHD
ASHTON-UNDER-LYNE	AHN
ASHURST	AHS
ASHURST NEW FOREST	ANF
ASHWELL & MORDEN	AWM
ASKAM	ASK
ASLOCKTON	ALK
ASPATRIA	ASP
ASPLEY GUISE	APG
ASTON	AST
ATHERSTONE	ATH
ATHERTON	ATN
ATTADALE	ATT
ATTENBOROUGH	ATB
ATTLEBOROUGH	ATL
AUCHINLECK	AUK
AUDLEY END	AUD
AUGHTON PARK	AUG
AVIEMORE	AVM
AVONCLIFF	AVF
AVONMOUTH	AVN
AXMINSTER	AXM
AYLESBURY	AYS
AYLESBURY VALE PARKWAY	AVP
AYLESFORD	AYL
AYLESHAM	AYH
AYR	AYR
BACHE	BAC
BAGLAN	BAJ
BAGSHOT	BAG
BAILDON	BLD
BAILLIESTON	BIO
BALCOMBE	BAB
BALDOCK	BDK
BALHAM	BAL
BALLOCH	BHC
BALMOSSIE	BSI
BAMBER BRIDGE	BMB
BAMFORD	BAM
BANAVIE	BNV
BANBURY	BAN
BANGOR (GWYNEDD)	BNG
BANK HALL	BAH
BANSTEAD	BAD
BARASSIE	BSS
BARDON MILL	BLL
BARE LANE	BAR
BARGEDDIE	BGI
BARGOED	BGD
BARKING	BKG
BARKING RIVERSIDE	BGV
BARMING	BMG
BARMOUTH	BRM
BARNEHURST	BNH
BARNES	BNS
BARNES BRIDGE	BNI
BARNETBY	BTB
BARNHAM	BAA
BARNHILL	BNL
BARNSLEY	BNY
BARNSTAPLE	BNP
BARNT GREEN	BTG
BARRHEAD	BRR
BARRHILL	BRL
BARROW HAVEN	BAV
BARROW-IN-FURNESS	BIF
BARROW-UPON-SOAR	BWS
BARRY	BRY
BARRY DOCKS	BYD
BARRY ISLAND	BYI
BARRY LINKS	BYL
BARTON-ON-HUMBER	BAU
BASILDON	BSO
BASINGSTOKE	BSK
BAT & BALL	BBL
BATH SPA	BTH
BATHGATE	BHG
BATLEY	BTL
BATTERSBY	BTT
BATTERSEA PARK	BAK
BATTLE	BAT
BATTLESBRIDGE	BLB
BAYFORD	BAY
BEACONSFIELD	BCF
BEARLEY	BER
BEARSDEN	BRN
BEARSTED	BSD
BEASDALE	BSL
BEAULIEU ROAD	BEU
BEAULY	BEL
BEBINGTON	BEB
BECCLES	BCC
BECKENHAM HILL	BEC
BECKENHAM JUNCTION	BKJ
BEDFORD	BDM
BEDFORD ST JOHNS	BSJ
BEDHAMPTON	BDH
BEDMINSTER	BMT
BEDWORTH	BEH
BEDWYN	BDW
BEESTON	BEE
BEKESBOURNE	BKS
BELLE VUE	BLV
BELLGROVE	BLG
BELLINGHAM	BGM
BELLSHILL	BLH
BELMONT	BLM
BELPER	BLP
BELTRING	BEG
BELVEDERE	BVD
BEMPTON	BEM
BEN RHYDDING	BEY
BENFLEET	BEF
BENTHAM	BEN
BENTLEY (HAMPSHIRE)	BTY
BENTLEY (SOUTH YORKSHIRE)	BYK
BERE ALSTON	BAS
BERE FERRERS	BFE
BERKHAMSTED	BKM
BERKSWELL	BKW
BERMUDA PARK	BEP
BERNEY ARMS	BYA
BERRY BROW	BBW
BERRYLANDS	BRS
BERWICK	BRK
BERWICK-UPON-TWEED	BWK
BESCAR LANE	BES
BESCOT STADIUM	BSC
BETCHWORTH	BTO
BETHNAL GREEN	BET
BETWS-Y-COED	BYC
BEVERLEY	BEV
BEXHILL	BEX
BEXLEY	BXY
BEXLEYHEATH	BXH
BICESTER NORTH	BCS
BICESTER VILLAGE	BIT
BICKLEY	BKL
BIDSTON	BID
BIGGLESWADE	BIW
BILBROOK	BBK
BILLERICAY	BIC
BILLINGHAM	BIL
BILLINGSHURST	BIG
BINGHAM	BIN
BINGLEY	BIY
BIRCHGROVE	BCG
BIRCHINGTON-ON-SEA	BCH
BIRCHWOOD	BWD
BIRKBECK	BIK
BIRKDALE	BDL
BIRKENHEAD CENTRAL	BKC
BIRKENHEAD HAMILTON SQUARE	BKQ
BIRKENHEAD NORTH	BKN
BIRKENHEAD PARK	BKP
BIRMINGHAM INTERNATIONAL	BHI
BIRMINGHAM MOOR STREET	BMO
BIRMINGHAM NEW STREET	BHM
BIRMINGHAM SNOW HILL	BSW
BISHOP AUCKLAND	BIA
BISHOPBRIGGS	BBG
BISHOP'S STORTFORD	BIS
BISHOPSTONE	BIP
BISHOPTON	BPT
BITTERNE	BTE
BLACKBURN	BBN
BLACKHEATH	BKH
BLACKHORSE ROAD	BHO
BLACKPOOL NORTH	BPN
BLACKPOOL PLEASURE BEACH	BPB
BLACKPOOL SOUTH	BPS
BLACKRIDGE	BKR
BLACKROD	BLK
BLACKWATER	BAW
BLAENAU FFESTINIOG	BFF
BLAIR ATHOLL	BLA
BLAIRHILL	BAI
BLAKE STREET	BKT
BLAKEDOWN	BKD
BLANTYRE	BLT
BLAYDON	BLO
BLEASBY	BSB
BLETCHLEY	BLY
BLOXWICH	BLX
BLOXWICH NORTH	BWN
BLUNDELLSANDS & CROSBY	BLN
BLYTHE BRIDGE	BYB
BODMIN PARKWAY	BOD
BODORGAN	BOR
BOGNOR REGIS	BOG
BOGSTON	BGS
BOLTON	BON
BOLTON-UPON-DEARNE	BTD
BOND STREET	BDS
BOOKHAM	BKA
BOOTLE	BOC
BOOTLE NEW STRAND	BNW
BOOTLE ORIEL ROAD	BOT
BORDESLEY	BBS
BOROUGH GREEN & WROTHAM	BRG
BORTH	BRH
BOSHAM	BOH
BOSTON	BSN
BOTLEY	BOE
BOTTESFORD	BTF
BOURNE END	BNE
BOURNEMOUTH	BMH
BOURNVILLE	BRV
BOW BRICKHILL	BWB
BOW STREET	BOW
BOWES PARK	BOP
BOWLING	BWG
BOX HILL & WESTHUMBLE	BXW
BRACKNELL	BCE
BRADFORD FORSTER SQUARE	BDQ
BRADFORD INTERCHANGE	BDI
BRADFORD-ON-AVON	BOA
BRADING	BDN
BRAINTREE	BTR
BRAINTREE FREEPORT	BTP
BRAMHALL	BML
BRAMLEY (HAMPSHIRE)	BMY
BRAMLEY (WEST YORKSHIRE)	BLE
BRAMPTON (CUMBRIA)	BMP
BRAMPTON (SUFFOLK)	BRP
BRANCHTON	BCN
BRANDON	BND
BRANKSOME	BSM
BRAYSTONES	BYS
BREDBURY	BDY
BREICH	BRC
BRENT CROSS WEST	BCZ
BRENTFORD	BFD
BRENTWOOD	BRE
BRICKET WOOD	BWO
BRIDGE OF ALLAN	BEA
BRIDGE OF ORCHY	BRO
BRIDGEND	BGN
BRIDGETON	BDG
BRIDGWATER	BWT
BRIDLINGTON	BDT
BRIERFIELD	BRF
BRIGG	BGG
BRIGHOUSE	BGH
BRIGHTON	BTN
BRIMSDOWN	BMD
BRINNINGTON	BNT
BRISTOL PARKWAY	BPW
BRISTOL TEMPLE MEADS	BRI
BRITHDIR	BHD
BRITON FERRY	BNF
BRIXTON	BRX
BROAD GREEN	BGE
BROADBOTTOM	BDB
BROADSTAIRS	BSR
BROCKENHURST	BCU
BROCKHOLES	BHS
BROCKLEY	BCY
BROMBOROUGH	BOM
BROMBOROUGH RAKE	BMR
BROMLEY CROSS	BMC
BROMLEY NORTH	BMN
BROMLEY SOUTH	BMS
BROMSGROVE	BMV
BRONDESBURY	BSY
BRONDESBURY PARK	BSP
BROOKMANS PARK	BPK
BROOKWOOD	BKO
BROOME	BME
BROOMFLEET	BMF
BRORA	BRA
BROUGH	BUH
BROUGHTY FERRY	BYF
BROXBOURNE	BXB
BRUCE GROVE	BCV
BRUNDALL	BDA
BRUNDALL GARDENS	BGA
BRUNSTANE	BSU
BRUNSWICK	BRW
BRUTON	BRU
BRYN	BYN
BUCKENHAM	BUC
BUCKLEY	BCK
BUCKNELL	BUK
BUCKSHAW PARKWAY	BSV
BUGLE	BGL
BUILTH ROAD	BHR
BULWELL	BLW
BURES	BUE
BURGESS HILL	BUG
BURLEY PARK	BUY
BURLEY-IN-WHARFEDALE	BUW
BURNAGE	BNA
BURNESIDE	BUD
BURNHAM	BNM
BURNHAM-ON-CROUCH	BUU
BURNLEY BARRACKS	BUB
BURNLEY CENTRAL	BNC
BURNLEY MANCHESTER ROAD	BYM
BURNSIDE	BUI
BURNTISLAND	BTS
BURSCOUGH BRIDGE	BCB
BURSCOUGH JUNCTION	BCJ
BURSLEDON	BUO
BURTON JOYCE	BUJ
BURTON-ON-TRENT	BUT
BURY ST EDMUNDS	BSE
BUSBY	BUS
BUSH HILL PARK	BHK
BUSHEY	BSH
BUTLERS LANE	BUL
BUXTED	BXD
BUXTON	BUX
BYFLEET & NEW HAW	BFN
BYNEA	BYE
CADOXTON	CAD
CAERGWRLE	CGW
CAERPHILLY	CPH
CAERSWS	CWS
CALDERCRUIX	CAC
CALDICOT	CDT
CALEDONIAN ROAD AND BARNSBURY	CIR
CALSTOCK	CSK
CAM AND DURSLEY	CDU
CAMBERLEY	CAM
CAMBORNE	CBN
CAMBRIDGE HEATH	CBH
CAMBRIDGE	CBG
CAMBRIDGE NORTH	CMB
CAMBUSLANG	CBL
CAMDEN ROAD	CMD
CAMELON	CMO
CANADA WATER	ZCW
CANARY WHARF	CWX
CANLEY	CNL
CANNOCK	CAO
CANONBURY	CNN
CANTERBURY EAST	CBE
CANTERBURY WEST	CBW
CANTLEY	CNY
CAPENHURST	CPU
CARBIS BAY	CBB
CARDENDEN	CDD
CARDIFF BAY	CDB
CARDIFF CENTRAL	CDF
CARDIFF QUEEN STREET	CDQ
CARDONALD	CDO
CARDROSS	CDR
CARFIN	CRF
CARK & CARTMEL	CAK
CARLISLE	CAR
CARLTON	CTO
CARLUKE	CLU
CARMARTHEN	CMN
CARMYLE	CML
CARNFORTH	CNF
CARNOUSTIE	CAN
CARNTYNE	CAY
CARPENDERS PARK	CPK
CARRBRIDGE	CAG
CARSHALTON BEECHES	CSB
CARSHALTON	CSH
CARSTAIRS	CRS
CARTSDYKE	CDY
CASTLE BAR PARK	CBP
CASTLE CARY	CLC
CASTLEFORD	CFD
CASTLETON MOOR	CSM
CASTLETON	CAS
CATERHAM	CAT
CATFORD	CTF
CATFORD BRIDGE	CFB
CATHAYS	CYS
CATHCART	CCT
CATTAL	CTL
CAUSELAND	CAU
CEFN-Y-BEDD	CYB
CHADWELL HEATH	CTH
CHAFFORD HUNDRED LAKESIDE	CFH
CHALFONT & LATIMER	CFO
CHALKWELL	CHW
CHANDLER'S FORD	CFR
CHAPEL-EN-LE-FRITH	CEF
CHAPELTON (DEVON)	CPN
CHAPELTOWN	CLN
CHAPPEL AND WAKES COLNE	CWC
CHARING CROSS	CHC
CHARING	CHG
CHARLBURY	CBY
CHARLTON	CTN
CHARTHAM	CRT
CHASSEN ROAD	CSR
CHATELHERAULT	CTE
CHATHAM	CTM
CHATHILL	CHT
CHEADLE HULME	CHU
CHEAM	CHE
CHEDDINGTON	CED
CHELFORD	CEL
CHELMSFORD	CHM
CHELSFIELD	CLD
CHELTENHAM SPA	CNM
CHEPSTOW	CPW
CHERRY TREE	CYT
CHERTSEY	CHY
CHESHUNT	CHN
CHESSINGTON NORTH	CSN
CHESSINGTON SOUTH	CSS
CHESTER	CTR
CHESTER ROAD	CRD
CHESTER-LE-STREET	CLS
CHESTERFIELD	CHD
CHESTFIELD & SWALECLIFFE	CSW
CHETNOLE	CNO
CHICHESTER	CCH
CHILHAM	CIL
CHILWORTH	CHL
CHINGFORD	CHI
CHINLEY	CLY
CHIPPENHAM	CPM
CHIPSTEAD	CHP
CHIRK	CRK
CHISLEHURST	CIT
CHISWICK	CHK
CHOLSEY	CHO
CHORLEY	CRL
CHORLEYWOOD	CLW
CHRISTCHURCH	CHR
CHRIST'S HOSPITAL	CHH
CHURCH AND OSWALDTWISTLE	CTW
CHURCH FENTON	CHF
CHURCH STRETTON	CTT
CILMERI	CIM
CITY THAMESLINK	CTK
CLACTON-ON-SEA	CLT
CLANDON	CLA
CLAPHAM HIGH STREET	CLP
CLAPHAM JUNCTION	CLJ
CLAPHAM	CPY
CLAPTON	CPT
CLARBESTON ROAD	CLR
CLARKSTON	CKS
CLAVERDON	CLV
CLAYGATE	CLG
CLEETHORPES	CLE
CLELAND	CEA
CLIFTON	CLI
CLIFTON DOWN	CFN
CLITHEROE	CLH
CLOCK HOUSE	CLK
CLUNDERWEN	CUW
CLYDEBANK	CYK
COATBRIDGE CENTRAL	CBC
COATBRIDGE SUNNYSIDE	CBS
COATDYKE	COA
COBHAM & STOKE D'ABERNON	CSD
CODSALL	CSL
COGAN	CGN
COLCHESTER	COL
COLCHESTER TOWN	CET
COLESHILL PARKWAY	CEH
COLLINGHAM	CLM
COLLINGTON	CLL
COLNE	CNE
COLWALL	CWL
COLWYN BAY	CWB
COMBE	CME
COMMONDALE	COM
CONGLETON	CNG
CONISBROUGH	CNS
CONNEL FERRY	CON
CONON BRIDGE	CBD
CONONLEY	CEY
CONWAY PARK	CNP
CONWY	CNW
COODEN BEACH	COB
COOKHAM	COO
COOKSBRIDGE	CBR
COOMBE JUNCTION HALT	COE
COPPLESTONE	COP
CORBRIDGE	CRB
CORBY	COR
CORKERHILL	CKH
CORKICKLE	CKL
CORPACH	CPA
CORROUR	CRR
CORYTON	COY
COSELEY	CSY
COSFORD	COS
COSHAM	CSA
COTTINGHAM	CGM
COTTINGLEY	COT
COULSDON SOUTH	CDS
COULSDON TOWN	CDN
COVENTRY	COV
COVENTRY ARENA	CAA
COWDEN	CWN
COWDENBEATH	COW
CRADLEY HEATH	CRA
CRAIGENDORAN	CGD
CRAMLINGTON	CRM
CRANBROOK	CBK
CRAVEN ARMS	CRV
CRAWLEY	CRW
CRAYFORD	CRY
CREDITON	CDI
CRESSING	CES
CRESSINGTON	CSG
CRESWELL	CWD
CREWE	CRE
CREWKERNE	CKN
CREWS HILL	CWH
CRIANLARICH	CNR
CRICCIETH	CCC
CRICKLEWOOD	CRI
CROFTFOOT	CFF
CROFTON PARK	CFT
CROMER	CMR
CROMFORD	CMF
CROOKSTON	CKT
CROSS GATES	CRG
CROSSFLATTS	CFL
CROSSHILL	COI
CROSSKEYS	CKY
CROSSMYLOOF	CMY
CROSTON	CSO
CROUCH HILL	CRH
CROWBOROUGH	COH
CROWHURST	CWU
CROWLE	CWE
CROWTHORNE	CRN
CROY	CRO
CRYSTAL PALACE	CYP
CUDDINGTON	CUD
CUFFLEY	CUF
CULHAM	CUM
CULRAIN	CUA
CUMBERNAULD	CUB
CUPAR	CUP
CURRIEHILL	CUH
CUSTOM HOUSE	CUS
CUXTON	CUX
CWMBACH	CMH
CWMBRAN	CWM
CYNGHORDY	CYN
DAGENHAM DOCK	DDK
DAISY HILL	DSY
DALGETY BAY	DAG
DALMALLY	DAL
DALMARNOCK	DAK
DALMENY	DAM
DALMUIR	DMR
DALREOCH	DLR
DALRY	DLY
DALSTON	DLS
DALSTON JUNCTION	DLJ
DALSTON KINGSLAND	DLK
DALTON	DLT
DALWHINNIE	DLW
DANBY	DNY
DANESCOURT	DCT
DANZEY	DZY
DARLINGTON	DAR
DARNALL	DAN
DARSHAM	DSM
DARTFORD	DFD
DARTON	DRT
DARWEN	DWN
DATCHET	DAT
DAVENPORT	DVN
DAWLISH	DWL
DAWLISH WARREN	DWW
DEAL	DEA
DEAN	DEN
DEANSGATE	DGT
DEGANWY	DGY
DEIGHTON	DHN
DELAMERE	DLM
DENBY DALE	DBD
DENHAM	DNM
DENHAM GOLF CLUB	DGC
DENMARK HILL	DMK
DENT	DNT
DENTON	DTN
DEPTFORD	DEP
DERBY	DBY
DERBY ROAD	DBR
DEVONPORT	DPT
DEWSBURY	DEW
DIDCOT PARKWAY	DID
DIGBY AND SOWTON	DIG
DILTON MARSH	DMH
DINAS POWYS	DNS
DINAS RHONDDA	DMG
DINGLE ROAD	DGL
DINGWALL	DIN
DINSDALE	DND
DINTING	DTG
DISLEY	DSL
DISS	DIS
DOCKYARD	DOC
DODWORTH	DOD
DOLAU	DOL
DOLEHAM	DLH
DOLGARROG	DLG
DOLWYDDELAN	DWD
DONCASTER	DON
DORCHESTER SOUTH	DCH
DORCHESTER WEST	DCW
DORE & TOTLEY	DOR
DORKING	DKG
DORKING DEEPDENE	DPD
DORKING WEST	DKT
DORMANS	DMS
DORRIDGE	DDG
DOVE HOLES	DVH
DOVER PRIORY	DVP
DOVERCOURT	DVC
DOVEY JUNCTION	DVY
DOWNHAM MARKET	DOW
DRAYTON GREEN	DRG
DRAYTON PARK	DYP
DREM	DRM
DRIFFIELD	DRF
DRIGG	DRI
DROITWICH SPA	DTW
DRONFIELD	DRO
DRUMCHAPEL	DMC
DRUMFROCHAR	DFR
DRUMGELLOCH	DRU
DRUMRY	DMY
DUDDESTON	DUD
DUDLEY PORT	DDP
DUFFIELD	DFI
DUIRINISH	DRN
DUKE STREET	DST
DULLINGHAM	DUL
DUMBARTON CENTRAL	DBC
DUMBARTON EAST	DBE
DUMBRECK	DUM
DUMFRIES	DMF
DUMPTON PARK	DMP
DUNBAR	DUN
DUNBLANE	DBL
DUNCRAIG	DCG
DUNDEE	DEE
DUNFERMLINE CITY	DFE
DUNFERMLINE QUEEN MARGARET	DFL
DUNKELD & BIRNAM	DKD
DUNLOP	DNL
DUNROBIN CASTLE	DNO
DUNSTON	DOT
DUNTON GREEN	DNG
DURHAM	DHM
DURRINGTON-ON-SEA	DUR
DYCE	DYC
DYFFRYN ARDUDWY	DYF
EAGLESCLIFFE	EAG
EALING BROADWAY	EAL
EARLESTOWN	ERL
EARLEY	EAR
EARLSFIELD	EAD
EARLSWOOD (SURREY)	ELD
EARLSWOOD (WEST MIDLANDS)	EWD
EAST CROYDON	ECR
EAST DIDSBURY	EDY
EAST DULWICH	EDW
EAST FARLEIGH	EFL
EAST GARFORTH	EGF
EAST GRINSTEAD	EGR
EAST KILBRIDE	EKL
EAST LINTON	ELT
EAST MALLING	EML
EAST MIDLANDS PARKWAY	EMD
EAST TILBURY	ETL
EAST WORTHING	EWR
EASTBOURNE	EBN
EASTBROOK	EBK
EASTERHOUSE	EST
EASTHAM RAKE	ERA
EASTLEIGH	ESL
EASTRINGTON	EGN
EBBSFLEET INTERNATIONAL	EBD
EBBW VALE PARKWAY	EBV
EBBW VALE TOWN	EBB
ECCLES	ECC
ECCLES ROAD	ECS
ECCLESTON PARK	ECL
EDALE	EDL
EDEN PARK	EDN
EDENBRIDGE	EBR
EDENBRIDGE TOWN	EBT
EDGE HILL	EDG
EDINBURGH GATEWAY	EGY
EDINBURGH PARK	EDP
EDINBURGH WAVERLEY	EDB
EDMONTON GREEN	EDR
EFFINGHAM JUNCTION	EFF
EGGESFORD	EGG
EGHAM	EGH
EGTON	EGT
ELEPHANT & CASTLE	EPH
ELGIN	ELG
ELLESMERE PORT	ELP
ELMERS END	ELE
ELMSTEAD WOODS	ESD
ELMSWELL	ESW
ELSECAR	ELR
ELSENHAM	ESM
ELSTREE & BOREHAMWOOD	ELS
ELTHAM	ELW
ELTON AND ORSTON	ELO
ELY	ELY
EMERSON PARK	EMP
EMSWORTH	EMS
ENERGLYN AND CHURCHILL PARK	ECP
ENFIELD CHASE	ENC
ENFIELD LOCK	ENL
ENFIELD TOWN	ENF
ENTWISTLE	ENT
EPSOM	EPS
EPSOM DOWNS	EPD
ERDINGTON	ERD
ERIDGE	ERI
ERITH	ERH
ESHER	ESH
ESKBANK	EKB
ESSEX ROAD	EXR
ETCHINGHAM	ETC
EUXTON BALSHAW LANE	EBA
EVESHAM	EVE
EWELL EAST	EWE
EWELL WEST	EWW
EXETER CENTRAL	EXC
EXETER ST DAVIDS	EXD
EXETER ST THOMAS	EXT
EXHIBITION CENTRE	EXG
EXMOUTH	EXM
EXTON	EXN
EYNSFORD	EYN
FAIRBOURNE	FRB
FAIRFIELD	FRF
FAIRLIE	FRL
FAIRWATER	FRW
FALCONWOOD	FCN
FALKIRK GRAHAMSTON	FKG
FALKIRK HIGH	FKK
FALLS OF CRUACHAN	FOC
FALMER	FMR
FALMOUTH DOCKS	FAL
FALMOUTH TOWN	FMT
FAREHAM	FRM
FARNBOROUGH (MAIN)	FNB
FARNBOROUGH NORTH	FNN
FARNCOMBE	FNC
FARNHAM	FNH
FARNINGHAM ROAD	FNR
FARNWORTH	FNW
FARRINGDON	ZFD
FAULDHOUSE	FLD
FAVERSHAM	FAV
FAYGATE	FGT
FAZAKERLEY	FAZ
FEARN	FRN
FEATHERSTONE	FEA
FELIXSTOWE	FLX
FELTHAM	FEL
FENITON	FNT
FENNY STRATFORD	FEN
FERNHILL	FER
FERRIBY	FRY
FERRYSIDE	FYS
FFAIRFACH	FFA
FILEY	FIL
FILTON ABBEY WOOD	FIT
FINCHLEY ROAD & FROGNAL	FNY
FINSBURY PARK	FPK
FINSTOCK	FIN
FISHBOURNE	FSB
FISHERSGATE	FSG
FISHGUARD AND GOODWICK	FGW
FISHGUARD HARBOUR	FGH
FISKERTON	FSK
FITZWILLIAM	FZW
FIVE WAYS	FWY
FLEET	FLE
FLIMBY	FLM
FLINT	FLN
FLITWICK	FLT
FLIXTON	FLI
FLOWERY FIELD	FLF
FOLKESTONE CENTRAL	FKC
FOLKESTONE WEST	FKW
FORD	FOD
FOREST GATE	FOG
FOREST HILL	FOH
FORMBY	FBY
FORRES	FOR
FORSINARD	FRS
FORT MATILDA	FTM
FORT WILLIAM	FTW
FOUR OAKS	FOK
FOXFIELD	FOX
FOXTON	FXN
FRANT	FRT
FRATTON	FTN
FRESHFIELD	FRE
FRESHFORD	FFD
FRIMLEY	FML
FRINTON-ON-SEA	FRI
FRIZINGHALL	FZH
FRODSHAM	FRD
FROME	FRO
FULWELL	FLW
FURNESS VALE	FNV
FURZE PLATT	FZP
GAINSBOROUGH CENTRAL	GNB
GAINSBOROUGH LEA ROAD	GBL
GALASHIELS	GAL
GARELOCHHEAD	GCH
GARFORTH	GRF
GARGRAVE	GGV
GARROWHILL	GAR
GARSCADDEN	GRS
GARSDALE	GSD
GARSTON	GSN
GARSWOOD	GSW
GARTCOSH	GRH
GARTH (BRIDGEND)	GMG
GARTH (POWYS)	GTH
GARVE	GVE
GATHURST	GST
GATLEY	GTY
GATWICK AIRPORT	GTW
GEORGEMAS JUNCTION	GGJ
GERRARDS CROSS	GER
GIDEA PARK	GDP
GIFFNOCK	GFN
GIGGLESWICK	GIG
GILBERDYKE	GBD
GILFACH FARGOED	GFF
GILLINGHAM (DORSET)	GIL
GILLINGHAM (KENT)	GLM
GILSHOCHILL	GSC
GIPSY HILL	GIP
GIRVAN	GIR
GLAISDALE	GLS
GLAN CONWY	GCW
GLASGOW CENTRAL	GLC
GLASGOW QUEEN STREET	GLQ
GLASSHOUGHTON	GLH
GLAZEBROOK	GLZ
GLENEAGLES	GLE
GLENFINNAN	GLF
GLENGARNOCK	GLG
GLENROTHES WITH THORNTON	GLT
GLOSSOP	GLO
GLOUCESTER	GCR
GLYNDE	GLY
GOBOWEN	GOB
GODALMING	GOD
GODLEY	GDL
GODSTONE	GDN
GOLDTHORPE	GOE
GOLF STREET	GOF
GOLSPIE	GOL
GOMSHALL	GOM
GOODMAYES	GMY
GOOLE	GOO
GOOSTREY	GTR
GORDON HILL	GDH
GOREBRIDGE	GBG
GORING & STREATLEY	GOR
GORING-BY-SEA	GBS
GORTON	GTO
GOSPEL OAK	GPO
GOUROCK	GRK
GOWERTON	GWN
GOXHILL	GOX
GRANGE PARK	GPK
GRANGE-OVER-SANDS	GOS
GRANGETOWN	GTN
GRANTHAM	GRA
GRATELEY	GRT
GRAVELLY HILL	GVH
GRAVESEND	GRV
GRAYS	GRY
GREAT AYTON	GTA
GREAT BENTLEY	GRB
GREAT CHESTERFORD	GRC
GREAT COATES	GCT
GREAT MALVERN	GMV
GREAT MISSENDEN	GMN
GREAT YARMOUTH	GYM
GREEN LANE	GNL
GREEN ROAD	GNR
GREENBANK	GBK
GREENFAULDS	GRL
GREENFIELD	GNF
GREENFORD	GFD
GREENHITHE	GNH
GREENOCK CENTRAL	GKC
GREENOCK WEST	GKW
GREENWICH	GNW
GRETNA GREEN	GEA
GRIMSBY DOCKS	GMD
GRIMSBY TOWN	GMB
GRINDLEFORD	GRN
GROSMONT	GMT
GROVE PARK	GRP
GUIDE BRIDGE	GUI
GUILDFORD	GLD
GUISELEY	GSY
GUNNERSBURY	GUN
GUNNISLAKE	GSL
GUNTON	GNT
GWERSYLLT	GWE
GYPSY LANE	GYP
HABROUGH	HAB
HACKBRIDGE	HCB
HACKNEY CENTRAL	HKC
HACKNEY DOWNS	HAC
HACKNEY WICK	HKW
HADDENHAM AND THAME PARKWAY	HDM
HADDISCOE	HAD
HADFIELD	HDF
HADLEY WOOD	HDW
HAG FOLD	HGF
HAGGERSTON	HGG
HAGLEY	HAG
HAIRMYRES	HMY
HALE	HAL
HALESWORTH	HAS
HALEWOOD	HED
HALIFAX	HFX
HALL GREEN	HLG
HALL I' TH' WOOD	HID
HALL ROAD	HLR
HALLING	HAI
HALTWHISTLE	HWH
HAM STREET	HMT
HAMBLE	HME
HAMILTON CENTRAL	HNC
HAMILTON WEST	HNW
HAMMERTON	HMM
HAMPDEN PARK	HMD
HAMPSTEAD HEATH	HDH
HAMPTON	HMP
HAMPTON COURT	HMC
HAMPTON WICK	HMW
HAMPTON-IN-ARDEN	HIA
HAMSTEAD	HSD
HAMWORTHY	HAM
HANBOROUGH	HND
HANDFORTH	HTH
HANWELL	HAN
HAPTON	HPN
HARLECH	HRL
HARLESDEN	HDN
HARLING ROAD	HRD
HARLINGTON	HLN
HARLOW MILL	HWM
HARLOW TOWN	HWN
HAROLD WOOD	HRO
HARPENDEN	HPD
HARRIETSHAM	HRM
HARRINGAY	HGY
HARRINGAY GREEN LANES	HRY
HARRINGTON	HRR
HARROGATE	HGT
HARROW & WEALDSTONE	HRW
HARROW-ON-THE-HILL	HOH
HARTFORD	HTF
HARTLEBURY	HBY
HARTLEPOOL	HPL
HARTWOOD	HTW
HARWICH INTERNATIONAL	HPQ
HARWICH TOWN	HWC
HASLEMERE	HSL
HASSOCKS	HSK
HASTINGS	HGS
HATCH END	HTE
HATFIELD	HAT
HATFIELD AND STAINFORTH	HFS
HATFIELD PEVEREL	HAP
HATHERSAGE	HSG
HATTERSLEY	HTY
HATTON	HTN
HAVANT	HAV
HAVENHOUSE	HVN
HAVERFORDWEST	HVF
HAWARDEN	HWD
HAWARDEN BRIDGE	HWB
HAWKHEAD	HKH
HAYDON BRIDGE	HDB
HAYDONS ROAD	HYR
HAYES	HYS
HAYES AND HARLINGTON	HAY
HAYLE	HYL
HAYMARKET	HYM
HAYWARDS HEATH	HHE
HAZEL GROVE	HAZ
HEADBOLT LANE	HBL
HEADCORN	HCN
HEADINGLEY	HDY
HEADSTONE LANE	HDL
HEALD GREEN	HDG
HEALING	HLI
HEATH HIGH LEVEL	HHL
HEATH LOW LEVEL	HLL
HEATHROW TERMINALS 2 & 3	HXX
HEATHROW TERMINAL 4	HAF
HEATHROW TERMINAL 5	HWV
HEATON CHAPEL	HTC
HEBDEN BRIDGE	HBD
HECKINGTON	HEC
HEDGE END	HDE
HEDNESFORD	HNF
HEIGHINGTON	HEI
HELENSBURGH CENTRAL	HLC
HELENSBURGH UPPER	HLU
HELLIFIELD	HLD
HELMSDALE	HMS
HELSBY	HSB
HEMEL HEMPSTEAD	HML
HENDON	HEN
HENGOED	HNG
HENLEY-IN-ARDEN	HNL
HENLEY-ON-THAMES	HOT
HENSALL	HEL
HEREFORD	HFD
HERNE BAY	HNB
HERNE HILL	HNH
HERSHAM	HER
HERTFORD EAST	HFE
HERTFORD NORTH	HFN
HESSLE	HES
HESWALL	HSW
HEVER	HEV
HEWORTH	HEW
HEXHAM	HEX
HEYFORD	HYD
HEYSHAM PORT	HHB
HIGH BROOMS	HIB
HIGH STREET (GLASGOW)	HST
HIGH WYCOMBE	HWY
HIGHAM	HGM
HIGHAMS PARK	HIP
HIGHBRIDGE AND BURNHAM	HIG
HIGHBURY AND ISLINGTON	HHY
HIGHTOWN	HTO
HILDENBOROUGH	HLB
HILLFOOT	HLF
HILLINGTON EAST	HLE
HILLINGTON WEST	HLW
HILLSIDE	HIL
HILSEA	HLS
HINCHLEY WOOD	HYW
HINCKLEY	HNK
HINDLEY	HIN
HINTON ADMIRAL	HNA
HITCHIN	HIT
HITHER GREEN	HGR
HOCKLEY	HOC
HOLLINGBOURNE	HBN
HOLMES CHAPEL	HCH
HOLMWOOD	HLM
HOLTON HEATH	HOL
HOLYHEAD	HHD
HOLYTOWN	HLY
HOMERTON	HMN
HONEYBOURNE	HYB
HONITON	HON
HONLEY	HOY
HONOR OAK PARK	HPA
HOOK	HOK
HOOTON	HOO
HOPE (DERBYSHIRE)	HOP
HOPE (FLINTSHIRE)	HPE
HOPTON HEATH	HPT
HORDEN	HRE
HORLEY	HOR
HORNBEAM PARK	HBP
HORNSEY	HRN
HORSFORTH	HRS
HORSHAM	HRH
HORSLEY	HSY
HORTON-IN-RIBBLESDALE	HIR
HORWICH PARKWAY	HWI
HOSCAR	HSC
HOUGH GREEN	HGN
HOUNSLOW	HOU
HOVE	HOV
HOVETON AND WROXHAM	HXM
HOW WOOD	HWW
HOWDEN	HOW
HOWWOOD	HOZ
HOXTON	HOX
HOYLAKE	HYK
HUBBERTS BRIDGE	HBB
HUCKNALL	HKN
HUDDERSFIELD	HUD
HULL PARAGON INTERCHANGE	HUL
HUMPHREY PARK	HUP
HUNCOAT	HCT
HUNGERFORD	HGD
HUNMANBY	HUB
HUNTINGDON	HUN
HUNTLY	HNT
HUNTS CROSS	HNX
HURST GREEN	HUR
HUTTON CRANSWICK	HUT
HUYTON	HUY
HYDE CENTRAL	HYC
HYDE NORTH	HYT
HYKEHAM	HKM
HYNDLAND	HYN
HYTHE	HYH
IFIELD	IFI
ILFORD	IFD
ILKESTON	ILN
ILKLEY	ILK
IMPERIAL WHARF	IMW
INCE	INC
INCE AND ELTON	INE
INGATESTONE	INT
INSCH	INS
INVERGORDON	IGD
INVERGOWRIE	ING
INVERKEITHING	INK
INVERKIP	INP
INVERNESS	INV
INVERNESS AIRPORT	IVA
INVERSHIN	INH
INVERURIE	INR
IPSWICH	IPS
IRLAM	IRL
IRVINE	IRV
ISLEWORTH	ISL
ISLIP	ISP
IVER	IVR
IVYBRIDGE	IVY
JAMES COOK UNIVERSITY HOSPITAL	JCH
JEWELLERY QUARTER	JEQ
JOHNSTON	JOH
JOHNSTONE	JHN
JORDANHILL	JOR
KEARSLEY	KSL
KEARSNEY	KSN
KEIGHLEY	KEI
KEITH	KEH
KELVEDON	KEL
KELVINDALE	KVD
KEMBLE	KEM
KEMPSTON HARDWICK	KMH
KEMPTON PARK	KMP
KEMSING	KMS
KEMSLEY	KML
KENDAL	KEN
KENILWORTH	KNW
KENLEY	KLY
KENNETT	KNE
KENNISHEAD	KNS
KENSAL GREEN	KNL
KENSAL RISE	KNR
KENSINGTON (OLYMPIA)	KPA
KENT HOUSE	KTH
KENTISH TOWN	KTN
KENTISH TOWN WEST	KTW
KENTON	KNT
KENTS BANK	KBK
KETTERING	KET
KEW BRIDGE	KWB
KEW GARDENS	KWG
KEYHAM	KEY
KEYNSHAM	KYN
KIDBROOKE	KDB
KIDDERMINSTER	KID
KIDSGROVE	KDG
KIDWELLY	KWL
KILBURN HIGH ROAD	KBN
KILDALE	KLD
KILDONAN	KIL
KILGETTY	KGT
KILMARNOCK	KMK
KILMAURS	KLM
KILPATRICK	KPT
KILWINNING	KWN
KINBRACE	KBC
KINGHAM	KGM
KINGHORN	KGH
KINGS LANGLEY	KGL
KING'S LYNN	KLN
KINGS NORTON	KNN
KINGS NYMPTON	KGN
KING'S PARK	KGP
KINGS SUTTON	KGS
KINGSKNOWE	KGE
KINGSTON	KNG
KINGSWOOD	KND
KINGUSSIE	KIN
KINTBURY	KIT
KINTORE	KTR
KIRBY CROSS	KBX
KIRK SANDALL	KKS
KIRKBY	KIR
KIRKBY-IN-ASHFIELD	KKB
KIRKBY-IN-FURNESS	KBF
KIRKBY STEPHEN	KSW
KIRKCALDY	KDY
KIRKCONNEL	KRK
KIRKDALE	KKD
KIRKHAM AND WESHAM	KKM
KIRKHILL	KKH
KIRKNEWTON	KKN
KIRKSTALL FORGE	KLF
KIRKWOOD	KWD
KIRTON LINDSEY	KTL
KIVETON BRIDGE	KIV
KIVETON PARK	KVP
KNARESBOROUGH	KNA
KNEBWORTH	KBW
KNIGHTON	KNI
KNOCKHOLT	KCK
KNOTTINGLEY	KNO
KNUCKLAS	KNU
KNUTSFORD	KNF
KYLE OF LOCHALSH	KYL
LADYBANK	LDY
LADYWELL	LAD
LAINDON	LAI
LAIRG	LRG
LAKE	LKE
LAKENHEATH	LAK
LAMPHEY	LAM
LANARK	LNK
LANCASTER	LAN
LANCING	LAC
LANDYWOOD	LAW
LANGBANK	LGB
LANGHO	LHO
LANGLEY	LNY
LANGLEY GREEN	LGG
LANGLEY MILL	LGM
LANGSIDE	LGS
LANGWATHBY	LGW
LANGWITH-WHALEY THORNS	LAG
LAPFORD	LAP
LAPWORTH	LPW
LARBERT	LBT
LARGS	LAR
LARKHALL	LRH
LAURENCEKIRK	LAU
LAWRENCE HILL	LWH
LAYTON	LAY
LAZONBY AND KIRKOSWALD	LZB
LEA BRIDGE	LEB
LEA GREEN	LEG
LEA HALL	LEH
LEAGRAVE	LEA
LEALHOLM	LHM
LEAMINGTON SPA	LMS
LEASOWE	LSW
LEATHERHEAD	LHD
LEDBURY	LED
LEE	LEE
LEEDS	LDS
LEICESTER	LEI
LEIGH	LIH
LEIGH ON SEA	LES
LEIGHTON BUZZARD	LBZ
LELANT	LEL
LELANT SALTINGS	LTS
LENHAM	LEN
LENZIE	LNZ
LEOMINSTER	LEO
LETCHWORTH GARDEN CITY	LET
LEUCHARS	LEU
LEVENSHULME	LVM
LEWES	LWS
LEWISHAM	LEW
LEYLAND	LEY
LEYTON MIDLAND ROAD	LEM
LEYTONSTONE HIGH ROAD	LER
LICHFIELD CITY	LIC
LICHFIELD TRENT VALLEY	LTV
LIDLINGTON	LID
LIMEHOUSE	LHS
LINCOLN	LCN
LINGFIELD	LFD
LINGWOOD	LGD
LINLITHGOW	LIN
LIPHOOK	LIP
LISKEARD	LSK
LISS	LIS
LISVANE AND THORNHILL	LVT
LITTLE KIMBLE	LTK
LITTLE SUTTON	LTT
LITTLEBOROUGH	LTL
LITTLEHAMPTON	LIT
LITTLEHAVEN	LVN
LITTLEPORT	LTP
LIVERPOOL CENTRAL	LVC
LIVERPOOL JAMES STREET	LVJ
LIVERPOOL LIME STREET	LIV
LIVERPOOL SOUTH PARKWAY	LPY
LIVINGSTON NORTH	LSN
LIVINGSTON SOUTH	LVG
LLANABER	LLA
LLANBEDR	LBR
LLANBISTER ROAD	LLT
LLANBRADACH	LNB
LLANDAF	LLN
LLANDANWG	LDN
LLANDECWYN	LLC
LLANDEILO	LLL
LLANDOVERY	LLV
LLANDRINDOD	LLO
LLANDUDNO	LLD
LLANDUDNO JUNCTION	LLJ
LLANDYBIE	LLI
LLANELLI	LLE
LLANFAIRFECHAN	LLF
LLANFAIRPWLL	LPG
LLANGADOG	LLG
LLANGAMMARCH	LLM
LLANGENNECH	LLH
LLANGYNLLO	LGO
LLANHARAN	LLR
LLANHILLETH	LTH
LLANISHEN	LLS
LLANRWST	LWR
LLANSAMLET	LAS
LLANTWIT MAJOR	LWM
LLANWRDA	LNR
LLANWRTYD	LNW
LLWYNGWRIL	LLW
LLWYNYPIA	LLY
LOCH AWE	LHA
LOCH EIL OUTWARD BOUND	LHE
LOCHAILORT	LCL
LOCHEILSIDE	LCS
LOCHGELLY	LCG
LOCHLUICHART	LCC
LOCHWINNOCH	LHW
LOCKERBIE	LOC
LOCKWOOD	LCK
LONDON BLACKFRIARS	BFR
LONDON BRIDGE	LBG
LONDON CANNON STREET	CST
LONDON CHARING CROSS	CHX
LONDON EUSTON	EUS
LONDON FENCHURCH STREET	FST
LONDON FIELDS	LOF
LONDON KING'S CROSS	KGX
LONDON LIVERPOOL STREET	LST
LONDON MARYLEBONE	MYB
LONDON PADDINGTON	PAD
LONDON ROAD (BRIGHTON)	LRB
LONDON ROAD (GUILDFORD)	LRD
LONDON ST PANCRAS INTERNATIONAL	STP
LONDON VICTORIA	VIC
LONDON WATERLOO	WAT
LONDON WATERLOO EAST	WAE
LONG BUCKBY	LBK
LONG EATON	LGE
LONG PRESTON	LPR
LONGBECK	LGK
LONGBRIDGE	LOB
LONGCROSS	LNG
LONGFIELD	LGF
LONGNIDDRY	LND
LONGPORT	LPT
LONGTON	LGN
LOOE	LOO
LOSTOCK	LOT
LOSTOCK GRALAM	LTG
LOSTOCK HALL	LOH
LOSTWITHIEL	LOS
LOUGHBOROUGH	LBO
LOUGHBOROUGH JUNCTION	LGJ
LOW MOOR	LMR
LOWDHAM	LOW
LOWER SYDENHAM	LSY
LOWESTOFT	LWT
LUDLOW	LUD
LUTON	LUT
LUTON AIRPORT PARKWAY	LTN
LUXULYAN	LUX
LYDNEY	LYD
LYE	LYE
LYMINGTON PIER	LYP
LYMINGTON TOWN	LYT
LYMPSTONE COMMANDO	LYC
LYMPSTONE VILLAGE	LYM
LYTHAM	LTM
MACCLESFIELD	MAC
MACHYNLLETH	MCN
MAESTEG	MST
MAESTEG (EWENNY ROAD)	MEW
MAGHULL	MAG
MAGHULL NORTH	MNS
MAIDEN NEWTON	MDN
MAIDENHEAD	MAI
MAIDSTONE BARRACKS	MDB
MAIDSTONE EAST	MDE
MAIDSTONE WEST	MDW
MALDEN MANOR	MAL
MALLAIG	MLG
MALTON	MLT
MALVERN LINK	MVL
MANCHESTER AIRPORT	MIA
MANCHESTER OXFORD ROAD	MCO
MANCHESTER PICCADILLY	MAN
MANCHESTER VICTORIA	MCV
MANEA	MNE
MANNINGTREE	MNG
MANOR PARK	MNP
MANOR ROAD	MNR
MANORBIER	MRB
MANORS	MAS
MANSFIELD	MFT
MANSFIELD WOODHOUSE	MSW
MARCH	MCH
MARDEN	MRN
MARGATE	MAR
MARKET HARBOROUGH	MHR
MARKET RASEN	MKR
MARKINCH	MNC
MARKS TEY	MKT
MARLOW	MLW
MARPLE	MPL
MARSDEN	MSN
MARSH BARTON	MBT
MARSKE	MSK
MARSTON GREEN	MGN
MARTIN MILL	MTM
MARTINS HERON	MAO
MARTON	MTO
MARYHILL	MYH
MARYLAND	MYL
MARYPORT	MRY
MATLOCK	MAT
MATLOCK BATH	MTB
MAULDETH ROAD	MAU
MAXWELL PARK	MAX
MAYBOLE	MAY
MAZE HILL	MZH
MEADOWHALL INTERCHANGE	MHS
MELDRETH	MEL
MELKSHAM	MKM
MELTON	MES
MELTON MOWBRAY	MMO
MENHENIOT	MEN
MENSTON	MNN
MEOLS	MEO
MEOLS COP	MEC
MEOPHAM	MEP
MERIDIAN WATER	MRW
MERRYTON	MEY
MERSTHAM	MHM
MERTHYR TYDFIL	MER
MERTHYR VALE	MEV
METHERINGHAM	MGM
METROCENTRE	MCE
MEXBOROUGH	MEX
MICHELDEVER	MIC
MICKLEFIELD	MIK
MIDDLESBROUGH	MBR
MIDDLEWOOD	MDL
MIDGHAM	MDG
MILFORD	MLF
MILFORD HAVEN	MFH
MILL HILL	MLH
MILL HILL BROADWAY	MIL
MILLBROOK (BEDFORDSHIRE)	MLB
MILLBROOK (HAMPSHIRE)	MBK
MILLIKEN PARK	MIN
MILLOM	MLM
MILLS HILL	MIH
MILNGAVIE	MLN
MILTON KEYNES CENTRAL	MKC
MINFFORDD	MFF
MINSTER	MSR
MIRFIELD	MIR
MISTLEY	MIS
MITCHAM EASTFIELDS	MTC
MITCHAM JUNCTION	MIJ
MOBBERLEY	MOB
MONIFIETH	MON
MONKS RISBOROUGH	MRS
MONTPELIER	MTP
MONTROSE	MTS
MOORFIELDS	MRF
MOORGATE	MOG
MOORSIDE	MSD
MOORTHORPE	MRP
MORAR	MRR
MORCHARD ROAD	MRD
MORDEN SOUTH	MDS
MORECAMBE	MCM
MORETON (DORSET)	MTN
MORETON (MERSEYSIDE)	MRT
MORETON-IN-MARSH	MIM
MORFA MAWDDACH	MFA
MORLEY	MLY
MORPETH	MPT
MORTIMER	MOR
MORTLAKE	MTL
MOSES GATE	MSS
MOSS SIDE	MOS
MOSSLEY	MSL
MOSSLEY HILL	MSH
MOSSPARK	MPK
MOSTON	MSO
MOTHERWELL	MTH
MOTSPUR PARK	MOT
MOTTINGHAM	MTG
MOTTISFONT & DUNBRIDGE	DBG
MOULDSWORTH	MLD
MOULSECOOMB	MCB
MOUNT FLORIDA	MFL
MOUNT VERNON	MTV
MOUNTAIN ASH	MTA
MUIR OF ORD	MOO
MUIREND	MUI
MUSSELBURGH	MUB
MYTHOLMROYD	MYT
NAFFERTON	NFN
NAILSEA AND BACKWELL	NLS
NAIRN	NRN
NANTWICH	NAN
NARBERTH	NAR
NARBOROUGH	NBR
NAVIGATION ROAD	NVR
NEATH	NTH
NEEDHAM MARKET	NMT
NEILSTON	NEI
NELSON	NEL
NESTON	NES
NETHERFIELD	NET
NETHERTOWN	NRT
NETLEY	NTL
NEW BARNET	NBA
NEW BECKENHAM	NBC
NEW BRIGHTON	NBN
NEW CLEE	NCE
NEW CROSS	NWX
NEW CROSS GATE	NXG
NEW CUMNOCK	NCK
NEW ELTHAM	NEH
NEW HOLLAND	NHL
NEW HYTHE	NHE
NEW LANE	NLN
NEW MALDEN	NEM
NEW MILLS CENTRAL	NMC
NEW MILLS NEWTOWN	NMN
NEW MILTON	NWM
NEW PUDSEY	NPD
NEW SOUTHGATE	NSG
NEWARK CASTLE	NCT
NEWARK NORTH GATE	NNG
NEWBRIDGE	NBE
NEWBURY	NBY
NEWBURY RACECOURSE	NRC
NEWCASTLE	NCL
NEWCOURT	NCO
NEWCRAIGHALL	NEW
NEWHAVEN HARBOUR	NVH
NEWHAVEN TOWN	NVN
NEWINGTON	NGT
NEWMARKET	NMK
NEWPORT (ESSEX)	NWE
NEWPORT (WALES)	NWP
NEWQUAY	NQY
NEWSTEAD	NSD
NEWTON	NTN
NEWTON ABBOT	NTA
NEWTON AYCLIFFE	NAY
NEWTON FOR HYDE	NWN
NEWTON-ON-AYR	NOA
NEWTON ST CYRES	NTC
NEWTON-LE-WILLOWS	NLW
NEWTONGRANGE	NEG
NEWTONMORE	NWR
NEWTOWN	NWT
NINIAN PARK	NNP
NITSHILL	NIT
NORBITON	NBT
NORBURY	NRB
NORMANS BAY	NSB
NORMANTON	NOR
NORTH BERWICK	NBW
NORTH CAMP	NCM
NORTH DULWICH	NDL
NORTH FAMBRIDGE	NFA
NORTH LLANRWST	NLR
NORTH QUEENSFERRY	NQU
NORTH ROAD	NRD
NORTH SHEEN	NSH
NORTH WALSHAM	NWA
NORTH WEMBLEY	NWB
NORTHALLERTON	NTR
NORTHAMPTON	NMP
NORTHFIELD	NFD
NORTHFLEET	NFL
NORTHOLT PARK	NLT
NORTHUMBERLAND PARK	NUM
NORTHWICH	NWI
NORWICH	NRW
NORWOOD JUNCTION	NWD
NOTTINGHAM	NOT
NUNEATON	NUN
NUNHEAD	NHD
NUNTHORPE	NNT
NUTBOURNE	NUT
NUTFIELD	NUF
OAKENGATES	OKN
OAKHAM	OKM
OAKLEIGH PARK	OKL
OBAN	OBN
OCKENDON	OCK
OCKLEY	OLY
OKEHAMPTON	OKE
OLD HILL	OHL
OLD ROAN	ORN
OLD STREET	OLD
OLDFIELD PARK	OLF
OLTON	OLT
ORE	ORE
ORMSKIRK	OMS
ORPINGTON	ORP
ORRELL	ORR
ORRELL PARK	OPK
OTFORD	OTF
OULTON BROAD NORTH	OUN
OULTON BROAD SOUTH	OUS
OUTWOOD	OUT
OVERPOOL	OVE
OVERTON	OVR
OXENHOLME LAKE DISTRICT	OXN
OXFORD	OXF
OXFORD PARKWAY	OXP
OXSHOTT	OXS
OXTED	OXT
PADDOCK WOOD	PDW
PADGATE	PDG
PAIGNTON	PGN
PAISLEY CANAL	PCN
PAISLEY GILMOUR STREET	PYG
PAISLEY ST JAMES	PYJ
PALMERS GREEN	PAL
PANGBOURNE	PAN
PANNAL	PNL
PANTYFFYNNON	PTF
PAR	PAR
PARBOLD	PBL
PARK STREET	PKT
PARKSTONE	PKS
PARSON STREET	PSN
PARTICK	PTK
PARTON	PRN
PATCHWAY	PWY
PATRICROFT	PAT
PATTERTON	PTT
PEARTREE	PEA
PECKHAM RYE	PMR
PEGSWOOD	PEG
PEMBERTON	PEM
PEMBREY AND BURRY PORT	PBY
PEMBROKE	PMB
PEMBROKE DOCK	PMD
PEN-Y-BONT	PNY
PENALLY	PNA
PENARTH	PEN
PENCOED	PCD
PENGAM	PGM
PENGE EAST	PNE
PENGE WEST	PNW
PENHELIG	PHG
PENISTONE	PNS
PENKRIDGE	PKG
PENMAENMAWR	PMW
PENMERE	PNM
PENRHIWCEIBER	PER
PENRHYNDEUDRAETH	PRH
PENRITH NORTH LAKES	PNR
PENRYN	PYN
PENSARN	PES
PENSHURST	PHR
PENTRE-BACH	PTB
PENYCHAIN	PNC
PENYFFORDD	PNF
PENZANCE	PNZ
PERRANWELL	PRW
PERRY BARR	PRY
PERSHORE	PSH
PERTH	PTH
PETERBOROUGH	PBO
PETERSFIELD	PTR
PETTS WOOD	PET
PEVENSEY AND WESTHAM	PEV
PEVENSEY BAY	PEB
PEWSEY	PEW
PILNING	PIL
PINHOE	PIN
PITLOCHRY	PIT
PITSEA	PSE
PLEASINGTON	PLS
PLOCKTON	PLK
PLUCKLEY	PLC
PLUMLEY	PLM
PLUMPTON	PMP
PLUMSTEAD	PLU
PLYMOUTH	PLY
POKESDOWN	POK
POLEGATE	PLG
POLESWORTH	PSW
POLLOKSHAWS EAST	PWE
POLLOKSHAWS WEST	PWW
POLLOKSHIELDS EAST	PLE
POLLOKSHIELDS WEST	PLW
POLMONT	PMT
POLSLOE BRIDGE	POL
PONDERS END	PON
PONT-Y-PANT	PYP
PONTARDDULAIS	PTD
PONTEFRACT BAGHILL	PFR
PONTEFRACT MONKHILL	PFM
PONTEFRACT TANSHELF	POT
PONTLOTTYN	PLT
PONTYCLUN	PYC
PONTYPOOL AND NEW INN	PPL
PONTYPRIDD	PPD
POOLE	POO
POPPLETON	POP
PORTWAY PARK & RIDE	PRI
PORT GLASGOW	PTG
PORT SUNLIGHT	PSL
PORT TALBOT PARKWAY	PTA
PORTCHESTER	PTC
PORTH	POR
PORTHMADOG	PTM
PORTLETHEN	PLN
PORTSLADE	PLD
PORTSMOUTH & SOUTHSEA	PMS
PORTSMOUTH ARMS	PMA
PORTSMOUTH HARBOUR	PMH
POSSILPARK AND PARKHOUSE	PPK
POTTERS BAR	PBR
POULTON-LE-FYLDE	PFY
POYNTON	PYT
PREES	PRS
PRESCOT	PSC
PRESTATYN	PRT
PRESTBURY	PRB
PRESTON	PRE
PRESTON PARK	PRP
PRESTONPANS	PST
PRESTWICK INTERNATIONAL AIRPORT	PRA
PRESTWICK TOWN	PTW
PRIESTHILL & DARNLEY	PTL
PRINCES RISBOROUGH	PRR
PRITTLEWELL	PRL
PRUDHOE	PRU
PULBOROUGH	PUL
PURFLEET	PFL
PURLEY	PUR
PURLEY OAKS	PUO
PUTNEY	PUT
PWLLHELI	PWL
PYE CORNER	PYE
PYLE	PYL
QUAKERS YARD	QYD
QUEENBOROUGH	QBR
QUEEN'S PARK (GLASGOW)	QPK
QUEEN'S PARK (LONDON)	QPW
QUEENS ROAD (PECKHAM)	QRP
QUEENSTOWN ROAD	QRB
QUINTRELL DOWNS	QUI
RADCLIFFE	RDF
RADLETT	RDT
RADLEY	RAD
RADYR	RDR
RAINFORD	RNF
RAINHAM (ESSEX)	RNM
RAINHAM (KENT)	RAI
RAINHILL	RNH
RAMSGATE	RAM
RAMSGREAVE AND WILPSHIRE	RGW
RANNOCH	RAN
RAUCEBY	RAU
RAVENGLASS FOR ESKDALE	RAV
RAVENSBOURNE	RVB
RAVENSTHORPE	RVN
RAWCLIFFE	RWC
RAYLEIGH	RLG
RAYNES PARK	RAY
READING	RDG
READING GREEN PARK	RDP
READING WEST	RDW
RECTORY ROAD	REC
REDBRIDGE	RDB
REDCAR CENTRAL	RCC
REDCAR EAST	RCE
REDDISH NORTH	RDN
REDDISH SOUTH	RDS
REDDITCH	RDC
REDHILL	RDH
REDLAND	RDA
REDRUTH	RED
REEDHAM (NORFOLK)	REE
REEDHAM (SURREY)	RHM
REIGATE	REI
RENTON	RTN
RESTON	RSN
RETFORD	RET
RHIWBINA	RHI
RHOOSE CARDIFF INTERNATIONAL AIRPORT	RIA
RHOSNEIGR	RHO
RHYL	RHL
RHYMNEY	RHY
RIBBLEHEAD	RHD
RICE LANE	RIL
RICHMOND	RMD
RICKMANSWORTH	RIC
RIDDLESDOWN	RDD
RIDGMONT	RID
RIDING MILL	RDM
RISCA AND PONTYMISTER	RCA
RISHTON	RIS
ROBERTSBRIDGE	RBR
ROBROYSTON	RRN
ROBY	ROB
ROCHDALE	RCD
ROCHE	ROC
ROCHESTER	RTR
ROCHFORD	RFD
ROCK FERRY	RFY
ROGART	ROG
ROGERSTONE	ROR
ROLLESTON	ROL
ROMAN BRIDGE	RMB
ROMFORD	RMF
ROMILEY	RML
ROMSEY	ROM
ROOSE	ROO
ROSE GROVE	RSG
ROSE HILL MARPLE	RSH
ROSYTH	ROS
ROTHERHAM CENTRAL	RMC
ROTHERHITHE	ROE
ROUGHTON ROAD	RNR
ROWLANDS CASTLE	RLN
ROWLEY REGIS	ROW
ROY BRIDGE	RYB
ROYDON	RYN
ROYSTON	RYS
RUABON	RUA
RUFFORD	RUF
RUGBY	RUG
RUGELEY TOWN	RGT
RUGELEY TRENT VALLEY	RGL
RUNCORN	RUN
RUNCORN EAST	RUE
RUSKINGTON	RKT
RUSWARP	RUS
RUTHERGLEN	RUT
RYDE ESPLANADE	RYD
RYDE PIER HEAD	RYP
RYDE ST JOHN'S ROAD	RYR
RYDER BROW	RRB
RYE	RYE
RYE HOUSE	RYH
ST ALBANS ABBEY	SAA
ST ALBANS CITY	SAC
ST ANDREWS ROAD	SAR
ST ANNES-ON-THE-SEA	SAS
ST AUSTELL	SAU
ST BEES	SBS
ST BUDEAUX FERRY ROAD	SBF
ST BUDEAUX VICTORIA ROAD	SBV
ST COLUMB ROAD	SCR
ST DENYS	SDN
ST ERTH	SER
ST GERMANS	SGM
ST HELENS CENTRAL	SNH
ST HELENS JUNCTION	SHJ
ST. HELIER	SIH
ST IVES	SIV
ST JAMES' PARK	SJP
ST. JAMES STREET	SJS
ST JOHNS	SAJ
ST KEYNE WISHING WELL HALT	SKN
ST LEONARDS WARRIOR SQUARE	SLQ
ST MARGARETS (HERTS)	SMT
ST MARGARETS (LONDON)	SMG
ST MARY CRAY	SMY
ST MICHAELS	STM
ST NEOTS	SNO
SALFORD CENTRAL	SFD
SALFORD CRESCENT	SLD
SALFORDS	SAF
SALHOUSE	SAH
SALISBURY	SAL
SALTAIRE	SAE
SALTASH	STS
SALTBURN	SLB
SALTCOATS	SLT
SALTMARSHE	SAM
SALWICK	SLW
SANDAL AND AGBRIGG	SNA
SANDBACH	SDB
SANDERSTEAD	SNR
SANDHILLS	SDL
SANDHURST	SND
SANDLING	SDG
SANDOWN	SAN
SANDPLACE	SDP
SANDWELL AND DUDLEY	SAD
SANDWICH	SDW
SANDY	SDY
SANKEY	SNK
SANQUHAR	SQH
SARN	SRR
SAUNDERSFOOT	SDF
SAUNDERTON	SDR
SAWBRIDGEWORTH	SAW
SAXILBY	SXY
SAXMUNDHAM	SAX
SCARBOROUGH	SCA
SCOTSCALDER	SCT
SCOTSTOUNHILL	SCH
SCUNTHORPE	SCU
SEA MILLS	SML
SEAFORD	SEF
SEAFORTH AND LITHERLAND	SFL
SEAHAM	SEA
SEAMER	SEM
SEASCALE	SSC
SEATON CAREW	SEC
SEER GREEN AND JORDANS	SRG
SELBY	SBY
SELHURST	SRS
SELLAFIELD	SEL
SELLING	SEG
SELLY OAK	SLY
SETTLE	SET
SEVEN KINGS	SVK
SEVEN SISTERS	SVS
SEVENOAKS	SEV
SEVERN BEACH	SVB
SEVERN TUNNEL JUNCTION	STJ
SHADWELL	SDE
SHALFORD	SFR
SHANKLIN	SHN
SHAWFAIR	SFI
SHAWFORD	SHW
SHAWLANDS	SHL
SHEERNESS-ON-SEA	SSS
SHEFFIELD	SHF
SHELFORD	SED
SHENFIELD	SNF
SHENSTONE	SEN
SHEPHERD'S BUSH	SPB
SHEPHERDS WELL	SPH
SHEPLEY	SPY
SHEPPERTON	SHP
SHEPRETH	STH
SHERBORNE	SHE
SHERBURN-IN-ELMET	SIE
SHERINGHAM	SHM
SHETTLESTON	SLS
SHIELDMUIR	SDM
SHIFNAL	SFN
SHILDON	SHD
SHIPLAKE	SHI
SHIPLEY	SHY
SHIPPEA HILL	SPP
SHIPTON	SIP
SHIREBROOK	SHB
SHIREHAMPTON	SHH
SHIREOAKS	SRO
SHIRLEY	SRL
SHOEBURYNESS	SRY
SHOLING	SHO
SHOREDITCH HIGH STREET	SDC
SHOREHAM	SEH
SHOREHAM-BY-SEA	SSE
SHORTLANDS	SRT
SHOTTON	SHT
SHOTTS	SHS
SHREWSBURY	SHR
SIDCUP	SID
SILEBY	SIL
SILECROFT	SIC
SILKSTONE COMMON	SLK
SILVER STREET	SLV
SILVERDALE	SVR
SINGER	SIN
SITTINGBOURNE	SIT
SKEGNESS	SKG
SKEWEN	SKE
SKIPTON	SKI
SLADE GREEN	SGR
SLAITHWAITE	SWT
SLATEFORD	SLA
SLEAFORD	SLR
SLEIGHTS	SLH
SLOUGH	SLO
SMALL HEATH	SMA
SMALLBROOK JUNCTION	SAB
SMETHWICK GALTON BRIDGE	SGB
SMETHWICK ROLFE STREET	SMR
SMITHY BRIDGE	SMB
SNAITH	SNI
SNODLAND	SDA
SNOWDOWN	SWO
SOHAM	SOJ
SOLE STREET	SOR
SOLIHULL	SOL
SOMERLEYTON	SYT
SOUTH ACTON	SAT
SOUTH BANK	SBK
SOUTH BERMONDSEY	SBM
SOUTH CROYDON	SCY
SOUTH ELMSALL	SES
SOUTH GREENFORD	SGN
SOUTH GYLE	SGL
SOUTH HAMPSTEAD	SOH
SOUTH KENTON	SOK
SOUTH MERTON	SMO
SOUTH MILFORD	SOM
SOUTH RUISLIP	SRU
SOUTH TOTTENHAM	STO
SOUTH WIGSTON	SWS
SOUTH WOODHAM FERRERS	SOF
SOUTHALL	STL
SOUTHAMPTON AIRPORT PARKWAY	SOA
SOUTHAMPTON CENTRAL	SOU
SOUTHBOURNE	SOB
SOUTHBURY	SBU
SOUTHEASE	SEE
SOUTHEND AIRPORT	SIA
SOUTHEND CENTRAL	SOC
SOUTHEND EAST	SOE
SOUTHEND VICTORIA	SOV
SOUTHMINSTER	SMN
SOUTHPORT	SOP
SOUTHWICK	SWK
SOWERBY BRIDGE	SOW
SPALDING	SPA
SPEAN BRIDGE	SBR
SPITAL	SPI
SPONDON	SPO
SPOONER ROW	SPN
SPRING ROAD	SRI
SPRINGBURN	SPR
SPRINGFIELD	SPF
SQUIRES GATE	SQU
STAFFORD	STA
STAINES	SNS
STALLINGBOROUGH	SLL
STALYBRIDGE	SYB
STAMFORD	SMD
STAMFORD HILL	SMH
STANFORD-LE-HOPE	SFO
STANLOW AND THORNTON	SNT
STANSTED AIRPORT	SSD
STANSTED MOUNTFITCHET	SST
STAPLEHURST	SPU
STAPLETON ROAD	SRD
STARBECK	SBE
STARCROSS	SCS
STAVELEY	SVL
STECHFORD	SCF
STEETON AND SILSDEN	SON
STEPPS	SPS
STEVENAGE	SVG
STEVENSTON	STV
STEWARTBY	SWR
STEWARTON	STT
STIRLING	STG
STOCKPORT	SPT
STOCKSFIELD	SKS
STOCKSMOOR	SSM
STOCKTON	STK
STOKE MANDEVILLE	SKM
STOKE NEWINGTON	SKW
STOKE-ON-TRENT	SOT
STONE	SNE
STONE CROSSING	SCG
STONEBRIDGE PARK	SBP
STONEGATE	SOG
STONEHAVEN	STN
STONEHOUSE	SHU
STONELEIGH	SNL
STOURBRIDGE JUNCTION	SBJ
STOURBRIDGE TOWN	SBT
STOW	SOI
STOWMARKET	SMK
STRANRAER	STR
STRATFORD	SRA
STRATFORD INTERNATIONAL	SFA
STRATFORD-UPON-AVON	SAV
STRATFORD-UPON-AVON PARKWAY	STY
STRATHCARRON	STC
STRAWBERRY HILL	STW
STREATHAM	STE
STREATHAM COMMON	SRC
STREATHAM HILL	SRH
STREETHOUSE	SHC
STRINES	SRN
STROMEFERRY	STF
STROOD	SOO
STROUD	STD
STURRY	STU
STYAL	SYA
SUDBURY	SUY
SUDBURY & HARROW ROAD	SUD
SUDBURY HILL HARROW	SDH
SUGAR LOAF	SUG
SUMMERSTON	SUM
SUNBURY	SUU
SUNDERLAND	SUN
SUNDRIDGE PARK	SUP
SUNNINGDALE	SNG
SUNNYMEADS	SNY
SURBITON	SUR
SURREY QUAYS	SQE
SUTTON COLDFIELD	SUT
SUTTON COMMON	SUC
SUTTON	SUO
SUTTON PARKWAY	SPK
SWALE	SWL
SWANLEY	SAY
SWANSCOMBE	SWM
SWANSEA	SWA
SWANWICK	SNW
SWAY	SWY
SWAYTHLING	SWG
SWINDERBY	SWD
SWINDON	SWI
SWINESHEAD	SWE
SWINTON (GREATER MANCHESTER)	SNN
SWINTON (SOUTH YORKSHIRE)	SWN
SYDENHAM HILL	SYH
SYDENHAM	SYD
SYON LANE	SYL
SYSTON	SYS
TACKLEY	TAC
TADWORTH	TAD
TAFFS WELL	TAF
TAIN	TAI
TAL-Y-CAFN	TLC
TALSARNAU	TAL
TALYBONT	TLB
TAME BRIDGE PARKWAY	TAB
TAMWORTH	TAM
TAPLOW	TAP
TATTENHAM CORNER	TAT
TAUNTON	TAU
TAYNUILT	TAY
TEDDINGTON	TED
TEESSIDE AIRPORT	TEA
TEIGNMOUTH	TGM
TELFORD CENTRAL	TFC
TEMPLECOMBE	TMC
TENBY	TEN
TEYNHAM	TEY
THAMES DITTON	THD
THANET PARKWAY	THP
THATCHAM	THA
THATTO HEATH	THH
THE HAWTHORNS	THW
THE LAKES	TLK
THEALE	THE
THEOBALDS GROVE	TEO
THETFORD	TTF
THIRSK	THI
THORNABY	TBY
THORNE NORTH	TNN
THORNE SOUTH	TNS
THORNFORD	THO
THORNLIEBANK	THB
THORNTON ABBEY	TNA
THORNTON HEATH	TTH
THORNTONHALL	THT
THORPE BAY	TPB
THORPE CULVERT	TPC
THORPE-LE-SOKEN	TLS
THREE BRIDGES	TBD
THREE OAKS	TOK
THURGARTON	THU
THURNSCOE	THC
THURSO	THS
THURSTON	TRS
TILBURY TOWN	TIL
TILE HILL	THL
TILEHURST	TLH
TIPTON	TIP
TIR-PHIL	TIR
TISBURY	TIS
TIVERTON PARKWAY	TVP
TODMORDEN	TOD
TOLWORTH	TOL
TON PENTRE	TPN
TONBRIDGE	TON
TONDU	TDU
TONFANAU	TNF
TONYPANDY	TNP
TOOTING	TOO
TOPSHAM	TOP
TORQUAY	TQY
TORRE	TRR
TOTNES	TOT
TOTTENHAM COURT ROAD	TCR
TOTTENHAM HALE	TOM
TOTTON	TTN
TOWN GREEN	TWN
TRAFFORD PARK	TRA
TREFOREST	TRF
TREFOREST ESTATE	TRE
TREHAFOD	TRH
TREHERBERT	TRB
TREORCHY	TRY
TRIMLEY	TRM
TRING	TRI
TROED-Y-RHIW	TRD
TROON	TRN
TROWBRIDGE	TRO
TRURO	TRU
TULLOCH	TUL
TULSE HILL	TUH
TUNBRIDGE WELLS	TBW
TURKEY STREET	TUR
TUTBURY AND HATTON	TUT
TWEEDBANK	TWB
TWICKENHAM	TWI
TWYFORD	TWY
TY CROES	TYC
TY GLAS	TGS
TYGWYN	TYG
TYNDRUM LOWER	TYL
TYSELEY	TYS
TYWYN	TYW
UCKFIELD	UCK
UDDINGSTON	UDD
ULCEBY	ULC
ULLESKELF	ULL
ULVERSTON	ULV
UMBERLEIGH	UMB
UNIVERSITY 	UNI
UPHALL	UHA
UPHOLLAND	UPL
UPMINSTER	UPM
UPPER HALLIFORD	UPH
UPPER HOLLOWAY	UHL
UPPER TYNDRUM	UTY
UPPER WARLINGHAM	UWL
UPTON	UPT
UPWEY	UPW
URMSTON	URM
UTTOXETER	UTT
VALLEY	VAL
VAUXHALL	VXH
VIRGINIA WATER	VIR
WADDON	WDO
WADHURST	WAD
WAINFLEET	WFL
WAKEFIELD KIRKGATE	WKK
WAKEFIELD WESTGATE	WKF
WALKDEN	WKD
WALLASEY GROVE ROAD	WLG
WALLASEY VILLAGE	WLV
WALLINGTON	WLT
WALLYFORD	WAF
WALMER	WAM
WALSALL	WSL
WALSDEN	WDN
WALTHAM CROSS	WLC
WALTHAMSTOW CENTRAL	WHC
WALTHAMSTOW QUEENS ROAD	WMW
WALTON (MERSEYSIDE)	WAO
WALTON-ON-THE-NAZE	WON
WALTON-ON-THAMES	WAL
WANBOROUGH	WAN
WANDSWORTH COMMON	WSW
WANDSWORTH ROAD	WWR
WANDSWORTH TOWN	WNT
WANSTEAD PARK	WNP
WAPPING	WPE
WARBLINGTON	WBL
WARE	WAR
WAREHAM	WRM
WARGRAVE	WGV
WARMINSTER	WMN
WARNHAM	WNH
WARRINGTON BANK QUAY	WBQ
WARRINGTON CENTRAL	WAC
WARRINGTON WEST	WAW
WARWICK	WRW
WARWICK PARKWAY	WRP
WATER ORTON	WTO
WATERBEACH	WBC
WATERINGBURY	WTR
WATERLOO (MERSEYSIDE)	WLO
WATFORD HIGH STREET	WFH
WATFORD JUNCTION	WFJ
WATFORD NORTH	WFN
WATLINGTON	WTG
WATTON-AT-STONE	WAS
WAUN-GRON PARK	WNG
WAVERTREE TECHNOLOGY PARK	WAV
WEELEY	WEE
WEETON	WET
WELHAM GREEN	WMG
WELLING	WLI
WELLINGBOROUGH	WEL
WELLINGTON	WLN
WELSHPOOL	WLP
WELWYN GARDEN CITY	WGC
WELWYN NORTH	WLW
WEM	WEM
WEMBLEY CENTRAL	WMB
WEMBLEY STADIUM	WCX
WEMYSS BAY	WMS
WENDOVER	WND
WENNINGTON	WNN
WEST ALLERTON	WSA
WEST BROMPTON	WBP
WEST BYFLEET	WBY
WEST CALDER	WCL
WEST CROYDON	WCY
WEST DRAYTON	WDT
WEST DULWICH	WDU
WEST EALING	WEA
WEST HAM	WEH
WEST HAMPSTEAD	WHD
WEST HAMPSTEAD THAMESLINK	WHP
WEST HORNDON	WHR
WEST KILBRIDE	WKB
WEST KIRBY	WKI
WEST MALLING	WMA
WEST NORWOOD	WNW
WEST RUISLIP	WRU
WEST RUNTON	WRN
WEST ST LEONARDS	WLD
WEST SUTTON	WSU
WEST WICKHAM	WWI
WEST WORTHING	WWO
WESTBURY	WSB
WESTCLIFF-ON-SEA	WCF
WESTCOMBE PARK	WCB
WESTENHANGER	WHA
WESTER HAILES	WTA
WESTERFIELD	WFI
WESTERTON	WES
WESTGATE-ON-SEA	WGA
WESTHOUGHTON	WHG
WESTON MILTON	WNM
WESTON-SUPER-MARE	WSM
WETHERAL	WRL
WEYBRIDGE	WYB
WEYMOUTH	WEY
WHALEY BRIDGE	WBR
WHALLEY	WHE
WHATSTANDWELL	WTS
WHIFFLET	WFF
WHIMPLE	WHM
WHINHILL	WNL
WHISTON	WHN
WHITBY	WTB
WHITCHURCH (CARDIFF)	WHT
WHITCHURCH (HAMPSHIRE)	WCH
WHITCHURCH (SHROPSHIRE)	WTC
WHITE HART LANE	WHL
WHITE NOTLEY	WNY
WHITECHAPEL	ZLW
WHITECRAIGS	WCR
WHITEHAVEN	WTH
WHITLAND	WTL
WHITLEY BRIDGE	WBD
WHITLOCKS END	WTE
WHITSTABLE	WHI
WHITTLESEA	WLE
WHITTLESFORD PARKWAY	WLF
WHITTON	WTN
WHITWELL	WWL
WHYTELEAFE	WHY
WHYTELEAFE SOUTH	WHS
WICK	WCK
WICKFORD	WIC
WICKHAM MARKET	WCM
WIDDRINGTON	WDD
WIDNES	WID
WIDNEY MANOR	WMR
WIGAN NORTH WESTERN	WGN
WIGAN WALLGATE	WGW
WIGTON	WGT
WILDMILL	WMI
WILLESDEN JUNCTION	WIJ
WILLIAMWOOD	WLM
WILLINGTON	WIL
WILMCOTE	WMC
WILMSLOW	WML
WILNECOTE	WNE
WIMBLEDON	WIM
WIMBLEDON CHASE	WBO
WINCHELSEA	WSE
WINCHESTER	WIN
WINCHFIELD	WNF
WINCHMORE HILL	WIH
WINDERMERE	WDM
WINDSOR AND ETON CENTRAL	WNC
WINDSOR AND ETON RIVERSIDE	WNR
WINNERSH	WNS
WINNERSH TRIANGLE	WTI
WINSFORD	WSF
WISHAW	WSH
WITHAM	WTM
WITLEY	WTY
WITTON	WTT
WIVELSFIELD	WVF
WIVENHOE	WIV
WOBURN SANDS	WOB
WOKING	WOK
WOKINGHAM	WKM
WOLDINGHAM	WOH
WOLVERHAMPTON	WVH
WOLVERTON	WOL
WOMBWELL	WOM
WOOD END	WDE
WOOD STREET	WST
WOODBRIDGE	WDB
WOODGRANGE PARK	WGR
WOODHALL	WDL
WOODHOUSE	WDH
WOODLESFORD	WDS
WOODLEY	WLY
WOODMANSTERNE	WME
WOODSMOOR	WSR
WOOL	WOO
WOOLSTON	WLS
WOOLWICH	WWC
WOOLWICH ARSENAL	WWA
WOOLWICH DOCKYARD	WWD
WOOTTON WAWEN	WWW
WORCESTER FOREGATE STREET	WOF
WORCESTER PARK	WCP
WORCESTER SHRUB HILL	WOS
WORCESTERSHIRE PARKWAY	WOP
WORKINGTON	WKG
WORKSOP	WRK
WORLE	WOR
WORPLESDON	WPL
WORSTEAD	WRT
WORTHING	WRH
WRABNESS	WRB
WRAYSBURY	WRY
WRENBURY	WRE
WRESSLE	WRS
WREXHAM CENTRAL	WXC
WREXHAM GENERAL	WRX
WYE	WYE
WYLAM	WYM
WYLDE GREEN	WYL
WYMONDHAM	WMD
WYTHALL	WYT
YALDING	YAL
YARDLEY WOOD	YRD
YARM	YRM
YATE	YAE
YATTON	YAT
YEOFORD	YEO
YEOVIL JUNCTION	YVJ
YEOVIL PEN MILL	YVP
YETMINSTER	YET
YNYSWEN	YNW
YOKER	YOK
YORK	YRK
YORTON	YRT
YSTRAD MYNACH	YSM
YSTRAD RHONDDA	YSR
